0 0 0 0 0 0 0 0 0 0 0 0 0 0 0 0 0 0 0 0 0 0 0 0 0 0 0 0 0 0 0 0 0 0 0 0 0 0 0 0 0 0 0 0 0 0 0 0 0 0 0 0 0 0 0 0 0 0 0 0 0 0 0 0 0 0 0 0 0 0 0 0 0 0 0 0 0 0 0 0 0 0 0 0 0 0 0 0 0 0 0 0 0 0 0 0 0 0 0 0 
0 0 0 0 0 0 0 0 0 0 0 0 0 0 0 0 0 0 0 0 0 0 0 0 0 0 0 0 0 0 0 0 0 0 0 0 0 0 0 0 0 0 0 0 0 0 0 0 0 0 0 0 0 0 0 0 0 0 0 0 0 0 0 0 0 0 0 0 0 0 0 0 0 0 0 0 0 0 0 0 0 0 0 0 0 0 0 0 0 0 0 0 0 0 0 0 0 0 0 0 
0 0 0 0 0 0 0 0 0 0 0 0 0 0 0 0 0 0 0 0 0 0 0 0 0 0 0 0 0 0 0 0 0 0 0 0 0 0 0 0 0 0 0 0 0 0 0 0 0 0 0 0 0 0 0 0 0 0 0 0 0 0 0 0 0 0 0 0 0 0 0 0 0 0 0 0 0 0 0 0 0 0 0 0 0 0 0 0 0 0 0 0 0 0 0 0 0 0 0 0 
0 0 0 0 0 0 0 0 0 0 0 0 0 0 0 0 0 0 0 0 0 0 0 0 0 0 0 0 0 0 0 0 0 0 0 0 0 0 0 0 0 0 0 0 0 0 0 0 0 0 0 0 0 0 0 0 0 0 0 0 0 0 0 0 0 0 0 0 0 0 0 0 0 0 0 0 0 0 0 0 0 0 0 0 0 0 0 0 0 0 0 0 0 0 0 0 0 0 0 0 
0 0 0 0 0 0 0 0 0 0 0 0 0 42 42 42 42 0 0 0 0 0 0 0 0 0 0 0 0 0 0 0 0 0 0 0 0 0 0 0 0 0 0 0 0 0 0 0 0 0 0 0 0 0 0 0 0 0 0 0 0 0 0 0 0 0 0 0 0 0 0 0 0 0 0 0 0 0 0 0 0 0 0 0 0 0 0 0 0 0 0 0 0 0 0 0 0 0 0 0 
0 0 0 0 0 0 0 0 0 0 0 0 42 42 41 41 42 42 0 0 0 0 0 0 0 0 0 0 0 0 0 0 0 0 0 0 0 0 0 0 0 0 0 0 0 0 0 0 0 0 0 0 0 0 0 0 0 0 0 0 0 0 0 0 42 42 42 42 0 0 0 0 0 0 0 0 42 42 42 42 0 0 0 0 0 0 0 0 0 0 0 0 0 0 0 0 0 0 0 0 
0 0 0 0 0 0 0 0 0 0 0 42 42 41 41 41 41 42 42 0 0 0 0 0 0 0 0 0 0 0 0 0 0 0 0 0 0 0 0 0 0 0 0 0 0 0 0 0 0 0 0 0 0 0 0 0 0 0 0 0 0 0 0 42 42 41 41 42 42 0 0 38 38 0 0 42 42 41 41 42 42 0 0 0 0 0 0 0 0 0 0 0 0 0 0 0 0 0 0 0 
0 0 0 0 0 0 0 0 0 0 42 42 41 41 41 41 41 41 42 42 0 0 0 0 0 0 0 0 0 0 0 0 0 0 0 0 0 0 0 0 0 0 0 0 0 0 0 0 0 0 0 0 0 0 0 0 0 0 0 0 0 0 42 42 41 41 41 41 42 42 0 38 38 0 42 42 41 41 41 41 42 42 0 0 0 0 0 0 0 0 0 0 0 0 0 0 0 0 0 0 
0 0 0 0 0 0 0 0 0 0 42 41 41 41 41 41 41 41 41 42 0 0 0 0 0 0 0 0 0 0 0 0 0 0 0 0 0 0 0 0 0 0 0 0 0 0 0 0 0 0 0 0 0 0 0 0 0 0 0 0 0 42 42 41 41 41 41 41 41 42 42 38 38 42 42 41 41 41 41 41 41 42 42 0 0 0 0 0 0 0 0 0 0 0 0 0 0 0 0 0 
0 0 0 0 0 0 0 0 0 0 42 41 41 41 41 41 41 41 41 42 0 0 0 0 0 0 0 0 0 0 0 0 0 0 0 0 0 0 0 0 0 0 0 0 0 0 0 0 0 0 0 0 0 0 0 0 0 0 0 0 0 42 41 41 41 41 41 41 41 41 41 41 41 41 41 41 41 41 41 41 41 41 42 0 0 0 0 0 0 0 0 0 0 0 0 0 0 0 0 0 
0 0 0 0 0 0 0 0 0 0 42 42 41 41 41 41 41 41 42 42 0 0 0 0 0 0 0 0 0 0 0 0 0 0 0 0 0 0 0 0 0 0 0 0 0 0 0 0 0 0 0 0 0 0 0 0 0 0 0 0 0 42 41 41 41 41 41 41 41 41 41 41 41 41 41 41 41 41 41 41 41 41 42 0 0 0 0 0 0 0 0 0 0 0 0 0 0 0 0 0 
0 0 0 0 0 0 0 0 0 0 0 42 42 41 41 41 41 42 42 0 0 0 0 0 0 0 0 0 0 0 0 0 0 0 0 0 0 0 0 0 0 0 0 0 0 0 0 0 0 0 0 0 0 0 0 0 0 0 0 0 0 42 42 41 41 41 41 41 41 42 42 42 42 42 42 41 41 41 41 41 41 42 42 0 0 0 0 0 0 0 0 0 0 0 0 0 0 0 0 0 
0 0 0 0 0 0 0 0 0 0 0 0 42 42 41 41 42 42 0 0 0 0 0 0 0 0 0 0 0 0 0 0 0 0 0 0 0 0 0 0 0 0 0 0 0 0 0 0 0 0 0 0 0 0 0 0 0 0 0 0 0 0 42 42 41 41 41 41 42 42 0 0 0 0 42 42 41 41 41 41 42 42 0 0 0 0 0 0 0 0 0 0 0 0 0 0 0 0 0 0 
0 0 0 0 0 0 0 0 0 0 0 0 0 42 41 41 42 0 0 0 0 0 0 0 0 0 0 0 0 0 0 0 0 0 0 0 0 0 0 0 0 0 0 0 0 0 0 0 0 0 0 0 0 0 0 0 0 0 0 0 0 0 0 42 42 41 41 42 42 0 0 0 0 0 0 42 42 41 41 42 42 0 0 0 0 0 0 0 0 0 0 0 0 0 0 0 0 0 0 0 
0 0 0 0 0 0 0 0 0 0 0 0 0 42 41 41 42 0 0 0 0 0 0 0 0 0 0 0 0 0 0 0 0 0 0 0 0 0 0 0 0 0 0 0 0 0 0 0 0 0 0 0 0 0 0 0 0 0 0 0 0 0 0 0 42 41 41 42 0 0 0 0 0 0 0 0 42 41 41 42 0 0 0 0 0 0 0 0 0 0 0 0 0 0 0 0 0 0 0 0 
0 0 0 0 0 0 0 0 0 0 0 0 0 42 41 41 42 0 0 0 0 0 0 0 0 0 0 0 0 0 42 42 42 42 42 42 0 0 0 0 0 0 0 0 0 0 0 0 0 0 0 0 0 0 0 0 0 0 0 0 0 0 0 0 42 41 41 42 0 0 0 0 0 0 0 0 42 41 41 42 0 0 0 0 0 0 0 0 0 0 0 0 0 0 0 0 0 0 0 0 
0 0 0 0 0 0 0 0 0 0 0 0 0 42 41 41 42 0 0 0 0 0 0 0 0 0 0 0 0 42 42 41 41 41 41 42 42 0 0 0 0 0 0 0 0 0 0 0 0 0 0 0 0 0 0 0 0 0 0 0 0 0 0 0 42 41 41 42 0 0 0 0 0 0 0 0 42 41 41 42 0 0 0 0 0 0 0 0 0 0 0 0 0 0 0 0 0 0 0 0 
0 0 42 42 42 42 0 0 0 0 0 0 42 42 41 41 42 42 0 0 0 0 0 0 0 0 0 0 0 42 41 41 41 41 41 41 42 0 0 0 0 0 0 0 0 0 0 0 42 42 42 42 0 0 0 0 0 0 0 0 0 0 0 0 42 41 41 42 0 0 0 0 0 0 0 0 42 41 41 42 0 0 0 0 0 0 0 0 0 0 0 0 0 0 0 0 0 0 0 0 
0 42 42 41 41 42 42 0 0 0 0 42 42 41 41 41 41 42 42 0 0 0 0 0 0 0 0 0 42 42 41 41 41 41 41 41 42 42 0 0 0 0 0 0 0 0 0 42 42 44 44 42 42 0 0 0 0 0 0 0 0 0 0 42 42 41 41 42 42 0 0 0 0 0 0 42 42 41 41 42 42 0 0 0 0 0 0 0 0 0 0 0 0 0 0 0 0 0 0 0 
42 42 41 41 41 41 42 42 0 0 42 42 41 41 41 41 41 41 42 42 0 0 0 0 0 0 0 0 42 41 41 41 41 41 41 41 41 42 0 0 0 0 0 0 0 0 42 42 44 44 44 44 42 42 0 0 0 0 0 0 0 0 42 42 41 41 41 41 42 42 0 0 0 0 42 42 41 41 41 41 42 42 0 0 0 0 0 0 0 0 0 0 0 0 0 0 0 0 0 0 
42 41 41 41 41 41 41 42 42 42 42 41 41 41 41 41 41 41 41 42 42 42 42 42 42 42 42 42 42 41 41 41 41 41 41 41 41 42 42 42 42 42 42 42 42 42 42 44 44 44 44 44 44 42 42 42 42 42 42 42 42 42 42 41 41 41 41 41 41 42 42 42 42 42 42 41 41 41 41 41 41 42 42 0 0 0 0 0 0 0 0 0 0 0 0 0 0 0 0 0 
42 41 41 32 32 41 41 41 41 41 41 41 41 41 41 41 41 41 41 41 41 41 41 41 41 41 41 41 41 41 41 41 41 41 41 41 41 41 41 41 41 41 41 41 41 41 41 41 41 41 41 41 41 41 41 41 41 41 41 41 41 41 41 41 41 41 41 41 41 41 41 41 41 41 41 41 41 41 41 41 41 41 42 0 0 0 0 0 0 0 0 0 0 0 0 0 0 0 0 0 
42 41 41 32 32 41 41 41 41 41 41 41 41 41 41 41 41 41 41 41 41 41 41 41 41 41 41 41 41 41 41 41 41 41 41 41 41 41 41 41 41 41 41 41 41 41 41 41 41 41 41 41 41 41 41 41 41 41 41 41 41 41 41 41 41 41 41 41 41 41 41 41 41 41 41 41 41 41 41 41 41 41 42 0 0 0 0 0 0 0 0 0 0 0 0 0 0 0 0 0 
42 41 41 41 41 41 41 42 42 42 42 41 41 41 41 41 41 41 41 42 42 42 42 42 42 42 42 42 42 41 41 41 41 41 41 41 41 42 42 42 42 42 42 42 42 42 42 44 44 41 41 44 44 42 42 42 42 42 42 42 42 42 42 41 41 41 41 41 41 42 42 42 42 42 42 41 41 41 41 41 41 42 42 0 0 0 0 0 0 0 0 0 0 0 0 0 0 0 0 0 
42 42 41 41 41 41 42 42 0 0 42 42 41 41 41 41 41 41 42 42 0 0 0 0 0 0 0 0 42 41 41 41 41 41 41 41 41 42 0 0 0 0 0 0 0 0 42 42 44 41 41 44 42 42 0 0 0 0 0 0 0 0 42 42 41 41 41 41 42 42 0 0 0 0 42 42 41 41 41 41 42 42 0 0 0 0 0 0 0 0 0 0 0 0 0 0 0 0 0 0 
0 42 42 41 41 42 42 0 0 0 0 42 42 41 41 41 41 42 42 0 0 0 0 0 0 0 0 0 42 42 41 41 41 41 41 41 42 42 0 0 0 0 0 0 0 0 0 42 42 41 41 42 42 0 0 0 0 0 0 0 0 0 0 42 42 41 41 42 42 0 0 0 0 0 0 42 42 41 41 42 42 0 0 0 0 0 0 0 0 0 0 0 0 0 0 0 0 0 0 0 
0 0 42 41 41 42 0 0 0 0 0 0 42 42 41 41 42 42 0 0 0 0 0 0 0 0 0 0 0 42 41 41 41 41 41 41 42 0 0 0 0 0 0 0 0 0 0 0 42 41 41 42 0 0 0 0 0 0 0 0 0 0 0 0 42 42 42 42 0 0 0 0 0 0 0 0 42 42 42 42 0 0 0 0 0 0 0 0 0 0 0 0 0 0 0 0 0 0 0 0 
0 0 42 41 41 42 0 0 0 0 0 0 0 42 42 42 42 0 0 0 0 0 0 0 0 0 0 0 0 42 42 41 41 41 41 42 42 0 0 0 0 0 0 0 0 0 0 0 42 41 41 42 0 0 0 0 0 0 0 0 0 0 0 0 0 0 0 0 0 0 0 0 0 0 0 0 0 0 0 0 0 0 0 0 0 0 0 0 0 0 0 0 0 0 0 0 0 0 0 0 
0 42 42 41 41 42 42 0 0 0 0 0 0 0 0 0 0 42 42 42 42 0 0 0 0 0 0 42 42 42 42 42 42 42 42 42 0 0 0 0 0 0 0 0 0 0 0 0 42 41 41 42 0 0 0 0 0 0 0 0 0 0 0 0 0 0 0 0 0 0 0 0 0 0 0 0 0 0 0 0 0 0 0 0 0 0 0 0 0 0 0 0 0 0 0 0 0 0 0 0 
42 42 41 41 41 41 42 42 0 0 0 0 0 0 0 0 42 42 41 41 42 42 0 0 0 0 42 42 41 41 42 42 0 0 0 0 0 0 0 0 0 0 0 0 0 0 0 0 42 41 41 42 0 0 0 0 0 0 0 0 0 0 0 0 0 0 0 0 0 0 0 0 0 0 0 0 0 0 0 0 0 0 0 0 0 0 0 0 0 0 0 0 0 0 0 0 0 0 0 0 
42 41 41 41 41 41 41 42 42 42 42 42 42 42 42 42 42 41 41 41 41 42 42 42 42 42 42 41 41 41 41 42 42 0 0 0 0 0 0 0 0 0 0 0 0 0 0 0 42 41 41 42 0 0 0 0 0 0 0 0 0 0 0 0 0 0 0 0 0 0 0 0 0 0 0 0 0 0 0 0 0 0 0 0 0 0 0 0 0 0 0 0 0 0 0 0 0 0 0 0 
42 41 41 41 41 41 41 41 41 41 41 41 41 41 41 41 41 41 41 41 41 41 41 41 41 41 41 41 41 41 41 41 42 0 0 0 0 0 0 0 0 0 0 0 0 0 0 0 42 41 41 42 0 0 0 0 0 0 0 0 0 0 0 0 0 0 0 0 0 0 0 0 0 0 0 0 0 0 0 0 0 0 0 0 0 0 0 0 0 0 0 0 0 0 0 0 0 0 0 0 
42 41 41 41 41 41 41 41 41 41 41 41 41 41 41 41 41 41 41 41 41 41 41 41 41 41 41 41 41 41 41 41 42 0 0 0 0 0 0 0 0 0 0 0 0 0 0 0 42 41 41 42 0 0 0 0 0 0 0 0 0 0 0 0 0 0 0 0 0 42 42 42 42 42 42 42 42 42 42 42 42 42 42 42 42 42 0 0 0 0 0 0 0 0 0 0 0 0 0 0 
42 41 41 41 41 41 41 42 42 42 42 42 42 42 42 42 42 41 41 41 41 42 42 42 42 42 42 41 41 41 41 42 42 0 0 0 0 42 42 42 42 42 0 0 0 0 0 0 42 41 41 42 0 0 0 0 0 0 0 0 0 0 0 0 0 0 0 0 42 42 41 41 41 41 41 41 41 41 41 41 41 41 41 41 41 42 42 0 0 0 0 0 0 0 0 0 0 0 0 0 
42 42 41 41 41 41 42 42 0 0 0 0 42 42 42 42 42 42 41 41 42 42 0 0 0 0 42 42 41 41 42 42 0 0 0 0 42 42 41 41 41 42 42 0 0 0 0 42 42 41 41 42 42 0 0 0 0 0 0 0 0 0 0 0 0 0 0 42 42 41 41 41 41 41 41 41 41 41 41 41 41 41 41 41 41 41 42 42 0 0 0 0 0 0 42 42 42 42 0 0 
0 42 42 41 41 42 42 0 0 0 0 42 42 41 41 42 42 42 42 42 42 0 0 0 0 0 0 42 42 42 42 0 0 0 0 42 42 44 41 41 41 44 42 42 0 0 42 42 41 41 41 41 42 42 0 0 0 0 0 0 0 0 0 0 0 0 0 42 41 41 41 41 41 41 41 41 41 41 41 41 41 41 41 41 41 41 41 42 0 0 0 0 0 42 42 44 44 42 42 0 
0 0 42 41 41 42 0 0 0 0 42 42 41 41 41 41 42 42 42 42 42 42 42 42 42 42 42 42 42 42 42 42 42 42 42 42 41 41 41 41 41 41 41 42 42 42 42 41 41 41 41 41 41 42 42 42 42 42 42 42 42 42 42 42 42 42 42 42 41 41 41 41 41 41 41 41 41 41 41 41 41 41 41 41 41 41 41 42 42 42 42 42 42 42 44 44 44 44 42 42 
0 0 42 41 41 42 0 0 0 0 42 44 44 41 41 41 41 41 41 41 41 41 41 41 41 41 41 41 41 41 41 41 41 41 41 41 41 41 41 41 41 41 41 41 41 41 41 41 41 41 41 41 41 41 41 41 41 41 41 41 41 41 41 41 41 41 41 41 41 41 41 41 41 41 41 41 41 41 41 41 41 41 41 41 41 41 41 41 41 41 41 41 41 41 41 41 41 44 44 42 
0 42 42 41 41 42 42 0 0 0 42 44 44 41 41 41 41 41 41 41 41 41 41 41 41 41 41 41 41 41 41 41 41 41 41 41 41 41 41 41 41 41 41 41 41 41 41 41 41 41 41 41 41 41 41 41 41 41 41 41 41 41 41 41 41 41 41 41 41 41 41 41 41 41 41 41 41 41 41 41 41 41 41 41 41 41 41 41 41 41 41 41 41 41 41 41 41 44 44 42 
0 42 44 41 41 44 42 42 0 0 42 42 41 41 41 41 42 42 42 42 42 42 42 42 42 42 42 42 42 42 42 42 42 42 42 42 41 41 41 41 41 41 41 42 42 42 42 41 41 41 41 41 41 42 42 42 42 42 42 42 42 42 42 42 42 42 42 42 41 41 41 41 41 41 41 41 41 41 41 41 41 41 41 41 41 41 41 42 42 42 42 42 42 42 44 41 41 44 42 42 
0 42 44 41 41 44 44 42 42 0 0 42 42 41 41 42 42 0 0 0 0 0 0 0 0 0 0 0 0 0 0 0 0 0 0 42 42 44 41 41 41 44 42 42 0 0 42 42 41 41 41 41 42 42 0 0 0 0 0 0 0 0 0 0 0 0 0 42 41 41 41 41 41 41 41 41 41 41 41 41 41 41 41 41 41 41 41 42 0 0 0 0 0 42 42 41 41 42 42 0 
0 42 44 41 41 44 44 44 42 0 0 0 42 41 41 42 0 0 0 0 0 42 42 42 42 0 0 0 42 42 42 42 0 0 0 0 42 42 41 41 41 42 42 0 0 0 0 42 42 41 41 42 42 0 0 0 0 0 0 0 0 0 0 0 0 0 0 42 42 41 41 41 41 41 41 41 41 41 41 41 41 41 41 41 41 41 42 42 0 0 0 0 0 0 42 41 41 42 0 0 
0 42 44 41 41 44 44 44 42 0 0 0 42 41 41 42 0 0 0 0 42 42 41 41 42 42 0 42 42 41 41 42 42 0 0 0 0 42 42 42 42 42 0 0 0 0 0 0 42 41 41 42 0 0 0 0 0 0 0 0 0 0 0 0 0 0 0 0 42 42 41 41 41 41 41 41 41 41 41 41 41 41 41 41 41 42 42 0 0 0 0 0 0 0 42 41 41 42 0 0 
0 42 44 41 41 44 44 44 42 0 0 0 42 41 41 42 0 0 0 42 42 41 41 41 41 42 42 42 41 41 41 41 42 42 0 0 0 0 0 0 0 0 0 0 0 0 0 0 42 41 41 42 0 0 0 0 0 0 0 0 0 0 0 0 0 0 0 0 0 42 42 42 42 42 42 42 42 42 42 42 42 42 42 42 42 42 0 0 0 0 0 0 0 0 42 41 41 42 0 0 
0 42 44 41 41 44 44 44 42 0 0 0 42 41 41 42 0 0 0 42 41 41 41 41 41 41 41 41 41 41 41 44 44 42 0 0 0 0 0 0 0 0 0 0 0 0 0 0 42 41 41 42 0 0 0 0 0 0 0 0 0 0 0 0 0 0 0 0 0 0 0 0 0 0 0 0 0 0 0 0 0 0 0 0 0 0 0 0 0 0 0 0 0 0 42 41 41 42 0 0 
0 42 44 41 41 44 44 44 42 0 0 0 42 41 41 42 0 0 0 42 41 41 41 41 41 41 41 41 41 41 41 44 44 42 0 0 0 0 0 0 0 0 0 0 0 0 0 0 42 41 41 42 0 0 0 0 0 0 0 0 0 0 0 0 0 0 0 0 0 0 0 0 0 0 0 0 0 0 0 0 0 0 0 0 0 0 0 0 0 0 0 0 0 0 42 41 41 42 0 0 
0 42 44 41 41 44 44 44 42 0 0 0 42 41 41 42 0 0 0 42 42 41 41 41 41 42 42 42 41 41 41 41 42 42 0 42 42 42 42 42 42 0 0 0 0 0 0 42 42 41 41 42 42 0 0 0 0 0 0 0 0 0 0 0 0 0 0 0 0 0 0 42 42 42 42 42 0 0 0 0 0 0 0 0 0 0 0 0 0 0 0 0 0 0 42 41 41 42 0 0 
0 42 44 41 41 44 44 44 42 0 0 0 42 41 41 42 0 0 0 0 42 42 41 41 42 42 0 42 42 41 41 42 42 0 42 42 41 41 41 41 42 42 0 0 0 0 42 42 41 41 41 41 42 42 0 0 0 0 0 0 42 42 42 42 0 0 0 0 0 0 42 42 44 44 44 42 42 0 0 0 0 0 0 0 0 0 0 0 0 0 0 0 0 0 42 41 41 42 0 0 
0 42 44 41 41 44 44 44 42 0 0 0 42 41 41 42 0 0 0 0 0 42 42 42 42 0 0 0 42 41 41 42 0 0 42 41 41 41 41 41 41 42 42 42 42 42 42 41 41 41 41 41 41 42 42 0 0 0 0 42 42 41 41 42 42 0 0 0 0 42 42 41 41 41 41 41 42 42 0 0 0 0 0 0 0 0 0 0 0 0 0 0 0 0 42 41 41 42 0 0 
0 42 44 41 41 44 44 44 42 0 0 42 42 41 41 42 42 0 0 0 0 0 0 0 0 0 0 42 42 41 41 42 42 0 42 41 41 41 41 41 41 41 41 41 41 41 41 41 41 17 17 17 41 41 42 42 42 42 42 42 41 41 41 41 42 42 42 42 42 42 44 44 44 44 44 41 41 42 0 0 0 0 0 0 0 0 0 0 0 0 0 0 0 0 42 41 41 42 0 0 
0 42 44 41 41 44 44 44 42 0 42 42 44 41 41 18 42 42 42 42 42 42 42 42 42 42 42 42 41 41 41 41 42 42 42 41 41 41 41 41 41 41 41 41 41 41 41 41 41 17 37 17 41 41 41 41 41 41 41 41 41 41 41 41 41 41 41 41 41 41 41 41 41 41 41 41 41 42 0 0 0 0 0 0 0 0 0 0 0 0 0 0 0 0 42 41 41 42 0 0 
0 42 44 41 41 44 44 44 42 0 42 41 41 41 41 41 41 41 41 41 41 41 41 41 41 41 41 41 41 41 41 41 41 42 42 41 41 41 41 41 41 42 42 42 42 42 42 41 41 17 17 17 41 41 41 41 41 41 41 41 41 41 41 41 41 41 41 41 41 41 41 41 41 41 41 41 41 42 0 0 0 42 42 42 42 42 0 0 0 0 0 0 0 42 42 41 41 42 42 0 
0 42 44 41 41 44 44 42 42 0 42 41 41 41 41 41 41 41 41 41 41 41 41 41 41 41 41 41 41 41 41 41 41 42 42 42 41 41 41 41 42 42 0 0 0 0 42 42 41 41 41 41 41 41 42 42 42 42 42 42 41 41 41 41 42 42 42 42 42 42 41 41 41 41 41 41 42 42 0 0 42 42 32 41 41 42 42 0 0 0 0 0 42 42 41 41 41 41 42 42 
0 42 44 41 41 44 42 42 0 0 42 42 44 41 41 18 42 42 42 42 42 42 42 42 42 42 42 42 41 41 41 41 42 42 0 42 42 42 42 42 42 0 0 0 0 0 0 42 42 41 41 41 41 42 42 0 0 0 0 42 42 41 41 42 42 0 0 0 0 42 42 41 41 41 41 42 42 0 0 42 42 41 41 41 41 32 42 42 42 42 42 42 42 41 41 41 41 41 41 42 
0 42 42 41 41 42 42 0 0 0 0 42 42 44 41 42 42 0 0 0 0 0 0 0 0 0 0 42 42 41 41 42 42 0 0 0 0 0 0 0 0 0 0 0 0 0 0 0 42 42 41 41 42 42 0 0 0 0 0 0 42 42 42 42 0 0 0 0 0 0 42 42 41 41 42 42 0 0 0 42 41 41 41 41 41 41 41 41 41 41 41 41 41 41 41 41 41 41 41 42 
0 0 42 41 41 42 0 0 0 0 0 0 42 42 42 42 0 0 0 0 0 0 0 0 0 0 0 0 42 42 42 42 0 0 0 0 0 0 0 0 0 0 0 0 0 0 0 0 0 42 41 41 42 0 0 0 0 0 0 0 0 0 0 0 0 0 0 0 0 0 0 42 41 41 42 0 0 0 0 42 41 41 41 41 41 41 41 41 41 41 41 41 41 41 41 41 41 41 41 42 
0 0 42 41 41 42 0 0 0 0 0 0 0 0 0 0 0 0 0 0 0 0 0 0 0 0 0 0 0 0 0 0 0 0 0 0 0 0 0 0 0 0 0 0 0 0 0 0 0 42 41 41 42 0 0 0 0 0 0 0 0 0 0 0 0 0 0 0 0 0 0 42 41 41 42 0 0 0 0 42 42 41 41 41 41 41 42 42 42 42 42 42 42 41 41 41 41 41 41 42 
0 42 42 41 41 42 42 0 0 0 0 0 0 0 0 0 0 0 0 0 0 0 0 0 42 42 42 42 0 0 0 0 0 0 0 0 0 0 0 0 42 42 42 42 0 0 0 0 0 42 41 41 42 0 0 0 0 0 0 0 0 0 0 0 0 0 0 0 0 0 0 42 41 41 42 0 0 0 0 0 42 42 41 41 41 42 42 0 0 0 0 0 42 42 41 41 41 41 42 42 
42 42 41 41 41 41 42 42 0 0 0 0 0 0 0 0 0 0 0 0 0 0 0 42 42 41 41 42 42 0 0 0 0 0 0 0 0 0 0 42 42 41 41 42 42 0 0 0 0 42 41 41 42 0 0 0 0 0 0 0 0 0 0 0 0 0 0 0 0 0 0 42 41 41 42 0 0 0 0 0 0 42 42 42 42 42 0 0 0 0 0 0 0 42 42 41 41 42 42 0 
42 41 41 41 41 41 41 42 42 0 0 0 0 0 0 0 0 0 0 0 0 0 42 42 41 41 41 41 42 42 0 0 0 0 0 0 0 0 42 42 41 41 41 41 42 42 0 0 0 42 41 41 42 0 0 0 0 0 0 0 0 0 0 0 0 0 0 0 0 0 0 42 41 41 42 0 0 0 0 0 0 0 0 0 0 0 0 0 0 0 0 0 0 0 42 41 41 42 0 0 
42 41 41 41 41 41 41 41 42 42 42 42 42 42 42 42 42 42 42 42 42 42 42 41 41 41 41 41 41 42 42 42 42 42 42 42 42 42 42 41 41 41 41 41 41 42 42 0 0 42 41 41 42 0 0 0 0 0 0 0 0 0 0 0 0 0 0 0 0 0 0 42 41 41 42 0 0 0 0 0 0 0 0 0 0 0 0 0 0 0 0 0 0 0 42 41 41 42 0 0 
42 41 42 41 41 42 41 41 41 41 41 41 41 41 41 41 41 41 41 41 41 41 41 41 41 41 41 41 41 41 41 41 41 41 41 41 41 41 41 41 41 41 41 41 41 41 42 0 0 42 41 41 42 0 0 0 0 0 0 0 0 0 0 0 0 0 0 0 0 0 42 42 41 41 42 42 0 0 0 0 0 0 0 0 0 0 0 0 0 0 0 0 0 0 42 41 41 42 0 0 
42 41 42 41 41 42 41 41 41 41 41 41 41 41 41 41 41 41 41 41 41 41 41 41 41 41 41 41 41 41 41 41 41 41 41 41 41 41 41 41 41 41 41 41 41 41 42 0 42 42 41 41 42 42 0 0 0 0 0 0 0 0 0 0 0 0 0 0 0 42 42 41 41 41 41 42 42 0 0 0 0 0 0 0 0 0 0 0 0 0 0 0 0 0 42 41 41 42 0 0 
42 41 41 41 41 41 41 41 42 42 42 42 42 42 42 42 42 42 42 42 42 42 42 41 41 41 41 41 41 42 42 42 42 42 42 42 42 42 42 41 41 41 41 41 41 42 42 42 42 38 41 41 38 42 42 42 0 0 0 0 0 0 0 0 0 0 0 0 42 42 41 41 41 41 41 41 42 42 0 0 0 0 0 0 0 0 0 0 0 0 0 0 0 0 42 41 41 42 0 0 
42 41 41 41 41 41 41 42 42 0 0 0 0 0 0 42 42 42 42 42 42 0 42 42 41 41 41 41 42 42 0 0 0 0 0 0 0 0 42 42 41 41 41 41 42 42 42 32 42 41 41 41 41 42 32 42 42 0 0 0 0 0 0 0 0 0 0 0 42 41 41 41 41 41 41 41 41 42 0 0 0 0 0 0 0 0 0 0 0 0 0 0 0 0 42 41 41 42 0 0 
42 42 41 41 41 41 42 42 0 0 0 0 0 0 42 42 41 41 41 41 42 42 0 42 42 41 41 42 42 0 0 0 0 0 42 42 42 42 0 42 42 41 41 42 42 42 32 42 41 41 41 41 41 41 42 32 42 0 0 0 0 0 0 0 0 0 0 0 42 41 41 41 41 41 41 41 41 42 0 0 0 0 0 0 0 0 0 0 0 0 0 0 0 0 42 41 41 42 0 0 
0 42 42 41 41 42 42 0 0 0 0 0 0 42 42 41 41 41 41 41 41 42 42 0 42 42 42 42 0 0 0 0 0 42 42 44 44 42 42 0 42 42 42 42 42 42 42 41 41 41 41 41 41 41 41 42 42 42 0 0 0 0 0 0 0 0 0 0 42 42 41 41 41 41 41 41 42 42 0 0 0 0 0 0 0 0 0 0 0 0 0 0 0 0 42 41 41 42 0 0 
0 0 42 41 41 42 0 0 0 0 0 32 32 42 17 41 41 42 42 41 41 41 42 42 0 0 0 0 0 0 0 0 42 42 41 41 41 41 42 42 0 0 0 0 42 44 41 41 41 41 17 17 17 41 41 41 44 42 0 0 0 0 0 0 0 0 0 0 0 42 42 41 41 41 41 42 42 0 0 0 0 0 0 0 0 0 0 0 0 0 0 0 42 42 42 41 41 42 42 42 
0 0 42 41 41 42 0 0 0 0 0 42 32 32 17 41 41 42 42 41 41 41 41 42 42 42 42 42 42 42 42 42 42 41 41 41 41 41 41 42 42 0 0 0 42 42 41 41 41 41 17 37 17 41 41 41 42 42 0 0 0 0 0 0 0 0 0 0 0 0 42 42 41 41 42 42 0 0 0 0 0 0 0 0 0 0 0 0 0 0 0 0 42 41 41 41 36 41 41 42 
0 42 42 41 41 42 42 0 0 0 0 42 32 37 17 41 41 41 41 41 41 41 41 41 41 41 41 41 41 41 41 41 41 41 41 44 44 41 41 41 42 0 0 0 42 42 41 41 41 41 17 17 17 41 41 41 42 42 0 0 0 0 0 0 0 0 0 0 0 0 0 42 41 41 42 0 0 0 0 0 0 0 0 0 0 0 0 0 0 0 0 0 42 42 41 41 41 41 42 42 
42 42 44 41 41 18 42 42 0 0 0 42 17 17 17 41 41 41 41 41 41 41 41 41 41 41 41 41 41 41 41 41 41 41 41 44 44 41 41 41 42 0 0 0 42 44 42 41 41 41 41 41 41 41 41 42 44 42 0 0 0 0 0 0 0 0 0 0 0 0 0 42 41 41 42 0 0 0 0 0 0 0 0 0 0 0 0 0 0 0 0 0 0 42 42 18 18 42 42 0 
42 44 44 41 41 18 18 42 0 0 0 42 42 41 41 41 41 42 42 41 41 41 41 42 42 42 42 42 42 42 42 42 42 41 41 41 41 41 41 42 42 0 0 0 42 42 32 32 42 41 41 41 41 42 32 32 42 42 0 0 0 0 0 0 0 0 0 0 0 0 0 42 41 41 42 0 0 0 0 0 0 0 0 0 0 0 0 0 0 0 0 0 0 0 42 42 42 42 0 0 
42 44 44 41 41 18 18 42 0 0 0 0 42 42 41 41 41 42 42 41 41 41 42 42 0 0 0 0 0 0 0 0 42 42 41 41 41 41 42 42 0 0 0 0 0 42 32 32 44 32 42 42 32 44 32 32 42 0 0 0 0 0 0 0 0 0 0 0 0 0 0 42 41 41 42 0 0 0 0 0 0 0 0 0 0 0 0 0 0 0 0 0 0 0 0 0 0 0 0 0 
42 44 44 41 41 18 18 42 0 0 0 0 0 42 42 41 41 41 41 41 41 42 42 0 0 0 0 0 0 0 0 0 0 42 42 41 41 42 42 0 0 0 0 0 0 42 42 42 42 42 42 42 42 42 42 42 42 0 0 0 0 0 0 0 0 0 0 0 0 0 0 42 41 41 42 0 0 0 0 0 0 0 0 0 0 0 0 0 0 0 0 0 0 0 0 0 0 0 0 0 
42 44 44 41 41 18 18 42 42 0 0 0 0 0 42 42 41 41 41 41 42 42 0 0 0 0 0 0 0 0 0 0 0 0 42 41 41 42 0 0 0 0 0 0 0 0 0 0 0 0 0 0 0 0 0 0 0 0 0 0 0 0 0 0 0 0 0 0 0 0 0 42 41 41 42 0 0 0 0 0 0 0 0 0 0 0 0 0 0 0 0 0 0 0 0 0 0 0 0 0 
42 44 44 41 41 18 18 18 42 0 0 0 0 0 0 42 42 42 42 42 42 0 0 0 0 0 0 0 0 0 0 0 0 0 42 41 41 42 0 0 0 0 0 0 0 0 0 0 0 0 0 0 0 0 0 0 0 0 0 0 0 0 0 0 0 0 0 0 0 0 0 42 41 41 42 0 0 0 0 0 0 0 0 0 0 0 0 0 0 0 0 0 0 0 0 0 0 0 0 0 
42 44 44 41 41 18 18 18 42 0 0 0 0 0 0 0 42 42 42 42 0 0 0 0 0 0 0 0 0 0 0 0 0 0 42 41 41 42 0 0 0 0 0 0 0 0 0 0 0 0 0 0 0 0 0 0 0 0 0 0 0 0 0 0 0 0 0 0 0 0 0 42 41 41 42 0 0 0 0 0 0 0 0 0 0 0 0 0 0 0 0 0 0 0 0 0 0 0 0 0 
42 42 44 41 41 18 42 42 42 0 0 0 0 0 0 42 42 41 41 42 42 0 0 0 0 0 0 0 0 0 0 0 0 0 42 41 41 42 0 0 0 0 0 0 0 0 0 0 0 0 0 0 0 0 0 0 0 0 0 0 0 0 0 0 0 0 0 0 0 0 0 42 41 41 42 0 0 0 0 0 0 0 0 0 0 0 0 0 0 0 0 0 0 0 0 0 0 0 0 0 
0 42 42 41 41 42 42 0 0 0 0 0 0 0 42 42 41 41 41 41 42 42 0 0 0 0 0 0 0 0 0 0 0 0 42 41 41 42 0 0 0 0 0 0 0 0 0 0 0 0 0 0 0 0 0 0 0 0 0 0 0 0 0 0 0 0 0 0 0 0 0 42 41 41 42 0 0 0 0 0 0 0 0 0 0 0 0 0 0 0 0 0 0 0 0 0 0 0 0 0 
0 0 42 41 41 42 0 0 0 0 0 0 0 42 42 41 41 41 41 41 41 42 42 0 0 0 0 0 0 0 0 0 0 0 42 41 41 42 0 0 0 0 0 0 0 0 0 0 0 0 0 0 0 0 0 0 0 0 0 0 0 0 0 0 0 0 0 0 0 0 42 42 41 41 42 42 0 0 0 0 0 0 0 0 0 0 0 0 0 0 0 0 0 0 0 0 0 0 0 0 
0 0 42 41 41 42 42 42 0 0 0 0 42 42 41 41 41 41 41 41 41 41 42 42 0 0 0 0 0 0 0 0 0 42 42 41 41 42 42 0 0 0 0 0 0 0 0 0 0 0 0 0 0 0 0 0 0 0 0 0 0 0 0 0 0 0 0 0 0 42 42 41 41 41 41 42 42 0 0 0 0 0 0 0 0 0 0 0 0 0 0 0 0 0 0 0 0 0 0 0 
0 0 42 41 41 41 41 42 0 0 0 42 42 41 41 41 41 41 41 41 41 41 41 42 42 0 0 0 0 0 0 0 42 42 41 41 41 41 42 42 0 0 0 0 0 0 0 0 0 0 0 0 0 0 0 0 0 0 0 0 0 0 0 0 0 0 0 0 42 42 41 41 41 41 41 41 42 42 0 0 0 0 0 0 0 0 0 0 0 0 0 0 0 0 0 0 0 0 0 0 
0 0 42 41 41 41 41 42 42 42 42 42 41 41 41 41 41 41 36 41 41 41 41 41 42 42 0 0 0 0 0 42 42 41 41 41 41 41 41 42 42 42 42 42 42 42 42 42 42 42 42 42 42 42 42 42 42 42 42 42 42 42 42 42 42 42 42 42 42 41 41 41 41 41 41 41 41 42 42 0 0 0 0 0 0 0 0 0 0 0 0 0 0 0 0 0 0 0 0 0 
0 42 42 41 41 41 41 41 41 41 41 41 41 41 41 41 41 41 36 41 41 41 41 41 41 42 0 0 0 0 0 42 41 41 41 44 44 41 41 41 41 41 41 41 41 41 41 41 41 41 41 41 41 41 41 41 41 41 41 41 41 41 41 41 41 41 41 41 41 41 41 41 44 44 41 41 41 41 42 0 0 0 0 0 0 0 0 0 0 0 0 0 0 0 0 0 0 0 0 0 
0 42 41 41 41 41 41 41 41 41 41 41 41 41 41 41 41 41 36 41 41 41 41 41 41 42 0 0 0 0 0 42 41 41 41 44 44 41 41 41 41 41 41 41 41 41 41 41 41 41 41 41 41 41 41 41 41 41 41 41 41 41 41 41 41 41 41 41 41 41 41 41 44 44 41 41 41 41 42 0 0 0 0 0 0 0 0 0 0 0 0 0 0 0 0 0 0 0 0 0 
0 42 41 41 42 42 42 42 42 42 42 42 41 41 41 41 41 41 36 41 41 41 41 41 42 42 0 0 0 0 0 42 42 41 41 41 41 41 41 42 42 42 42 42 42 42 42 42 42 42 42 42 42 42 42 42 42 42 42 42 42 42 42 42 42 42 42 42 42 41 41 41 41 41 41 41 41 42 42 0 0 0 0 0 0 0 0 0 0 0 0 0 0 0 0 0 0 0 0 0 
0 42 42 42 42 42 0 0 0 0 0 42 42 41 41 41 41 41 41 41 41 41 41 42 42 0 0 0 0 0 0 0 42 42 41 41 41 41 42 42 0 0 0 0 0 0 0 0 0 0 0 0 0 0 0 0 0 0 0 0 0 0 0 0 0 0 0 0 42 42 41 41 41 41 41 41 42 42 0 0 0 0 0 0 0 0 0 0 0 0 0 0 0 0 0 0 0 0 0 0 
0 0 0 0 0 0 0 0 0 0 0 0 42 42 41 41 41 41 41 41 41 41 42 42 0 0 0 0 0 0 0 0 0 42 42 41 41 42 42 0 0 0 0 0 0 0 0 0 0 0 0 0 0 0 0 0 0 0 0 0 0 0 0 0 0 0 0 0 0 42 42 41 41 41 41 42 42 0 0 0 0 0 0 0 0 0 0 0 0 0 0 0 0 0 0 0 0 0 0 0 
0 0 0 0 0 0 0 0 0 0 0 0 0 42 42 41 41 41 41 41 41 42 42 0 0 0 0 0 0 0 0 0 0 0 42 42 42 42 0 0 0 0 0 0 0 0 0 0 0 0 0 0 0 0 0 0 0 0 0 0 0 0 0 0 0 0 0 0 0 0 42 42 41 41 42 42 0 0 0 0 0 0 0 0 0 0 0 0 0 0 0 0 0 0 0 0 0 0 0 0 
0 0 0 0 0 0 0 0 0 0 0 0 0 0 42 42 41 41 41 41 42 42 0 0 0 0 0 0 0 0 0 0 0 0 0 0 0 0 0 0 0 0 0 0 0 0 0 0 0 0 0 0 0 0 0 0 0 0 0 0 0 0 0 0 0 0 0 0 0 0 0 42 42 42 42 0 0 0 0 0 0 0 0 0 0 0 0 0 0 0 0 0 0 0 0 0 0 0 0 0 
0 0 0 0 0 0 0 0 0 0 0 0 0 0 0 42 42 41 41 42 42 0 0 0 0 0 0 0 0 0 0 0 0 0 0 0 0 0 0 0 0 0 0 0 0 0 0 0 0 0 0 0 0 0 0 0 0 0 0 0 0 0 0 0 0 0 0 0 0 0 0 0 0 0 0 0 0 0 0 0 0 0 0 0 0 0 0 0 0 0 0 0 0 0 0 0 0 0 0 0 
0 0 0 0 0 0 0 0 0 0 0 0 0 0 0 0 42 42 42 42 0 0 0 0 0 0 0 0 0 0 0 0 0 0 0 0 0 0 0 0 0 0 0 0 0 0 0 0 0 0 0 0 0 0 0 0 0 0 0 0 0 0 0 0 0 0 0 0 0 0 0 0 0 0 0 0 0 0 0 0 0 0 0 0 0 0 0 0 0 0 0 0 0 0 0 0 0 0 0 0 
0 0 0 0 0 0 0 0 0 0 0 0 0 0 0 0 0 0 0 0 0 0 0 0 0 0 0 0 0 0 0 0 0 0 0 0 0 0 0 0 0 0 0 0 0 0 0 0 0 0 0 0 0 0 0 0 0 0 0 0 0 0 0 0 0 0 0 0 0 0 0 0 0 0 0 0 0 0 0 0 0 0 0 0 0 0 0 0 0 0 0 0 0 0 0 0 0 0 0 0 
0 0 0 0 0 0 0 0 0 0 0 0 0 0 0 0 0 0 0 0 0 0 0 0 0 0 0 0 0 0 0 0 0 0 0 0 0 0 0 0 0 0 0 0 0 0 0 0 0 0 0 0 0 0 0 0 0 0 0 0 0 0 0 0 0 0 0 0 0 0 0 0 0 0 0 0 0 0 0 0 0 0 0 0 0 0 0 0 0 0 0 0 0 0 0 0 0 0 0 0 
0 0 0 0 0 0 0 0 0 0 0 0 0 0 0 0 0 0 0 0 0 0 0 0 0 0 0 0 0 0 0 0 0 0 0 0 0 0 0 0 0 0 0 0 0 0 0 0 0 0 0 0 0 0 0 0 0 0 0 0 0 0 0 0 0 0 0 0 0 0 0 0 0 0 0 0 0 0 0 0 0 0 0 0 0 0 0 0 0 0 0 0 0 0 0 0 0 0 0 0 
0 0 0 0 0 0 0 0 0 0 0 0 0 0 0 0 0 0 0 0 0 0 0 0 0 0 0 0 0 0 0 0 0 0 0 0 0 0 0 0 0 0 0 0 0 0 0 0 0 0 0 0 0 0 0 0 0 0 0 0 0 0 0 0 0 0 0 0 0 0 0 0 0 0 0 0 0 0 0 0 0 0 0 0 0 0 0 0 0 0 0 0 0 0 0 0 0 0 0 0 
0 0 0 0 0 0 0 0 0 0 0 0 0 0 0 0 0 0 0 0 0 0 0 0 0 0 0 0 0 0 0 0 0 0 0 0 0 0 0 0 0 0 0 0 0 0 0 0 0 0 0 0 0 0 0 0 0 0 0 0 0 0 0 0 0 0 0 0 0 0 0 0 0 0 0 0 0 0 0 0 0 0 0 0 0 0 0 0 0 0 0 0 0 0 0 0 0 0 0 0 
0 0 0 0 0 0 0 0 0 0 0 0 0 0 0 0 0 0 0 0 0 0 0 0 0 0 0 0 0 0 0 0 0 0 0 0 0 0 0 0 0 0 0 0 0 0 0 0 0 0 0 0 0 0 0 0 0 0 0 0 0 0 0 0 0 0 0 0 0 0 0 0 0 0 0 0 0 0 0 0 0 0 0 0 0 0 0 0 0 0 0 0 0 0 0 0 0 0 0 0 
0 0 0 0 0 0 0 0 0 0 0 0 0 0 0 0 0 0 0 0 0 0 0 0 0 0 0 0 0 0 0 0 0 0 0 0 0 0 0 0 0 0 0 0 0 0 0 0 0 0 0 0 0 0 0 0 0 0 0 0 0 0 0 0 0 0 0 0 0 0 0 0 0 0 0 0 0 0 0 0 0 0 0 0 0 0 0 0 0 0 0 0 0 0 0 0 0 0 0 0 
0 0 0 0 0 0 0 0 0 0 0 0 0 0 0 0 0 0 0 0 0 0 0 0 0 0 0 0 0 0 0 0 0 0 0 0 0 0 0 0 0 0 0 0 0 0 0 0 0 0 0 0 0 0 0 0 0 0 0 0 0 0 0 0 0 0 0 0 0 0 0 0 0 0 0 0 0 0 0 0 0 0 0 0 0 0 0 0 0 0 0 0 0 0 0 0 0 0 0 0 
