18 18 18 18 18 18 18 18 18 18 18 18 18 18 18 18 18 18 18 18 18 18 18 18 18 18 18 18 18 18 18 18 18 18 18 18 18 18 18 18 18 18 18 18 18 18 18 18 18 18 18 18 18 18 18 18 18 18 18 18 18 18 18 18 18 18 18 18 18 18 18 18 18 18 18 18 18 18 18 18 18 18 18 18 18 18 18 18 18 18 18 18 18 18 18 18 18 18 18 18 
18 18 18 18 18 18 18 18 18 18 18 18 18 18 18 18 18 18 18 18 18 18 18 18 18 18 18 18 18 18 18 18 18 18 18 18 18 18 18 18 18 18 18 18 18 18 18 18 18 18 18 18 18 18 18 18 18 18 18 18 18 18 18 18 18 18 18 18 18 18 18 18 18 18 18 18 18 18 18 18 18 18 18 18 18 18 18 18 18 18 18 18 18 18 18 18 18 18 18 18 
18 18 18 18 18 18 18 18 18 18 18 18 18 18 18 18 18 18 18 18 18 18 18 18 18 18 18 18 18 18 18 18 18 18 18 18 18 18 18 18 18 18 18 18 18 18 18 18 18 18 18 18 18 18 18 18 18 18 18 18 18 18 18 18 18 18 18 18 18 18 18 18 18 18 18 18 18 18 18 18 18 18 18 18 18 18 18 18 18 18 18 18 18 18 18 18 18 18 18 18 
18 18 18 18 18 18 18 18 18 18 18 18 18 18 18 18 18 18 39 39 39 39 39 18 18 18 18 18 18 18 18 18 18 18 18 18 18 18 18 18 18 18 18 18 18 18 18 18 18 18 18 18 18 18 18 18 18 18 18 18 18 18 18 18 18 18 18 18 18 18 18 18 18 18 18 18 18 18 18 18 18 18 18 18 18 18 18 18 18 18 18 18 18 18 18 18 18 18 18 18 
18 18 18 18 18 18 18 18 18 18 18 18 18 18 18 39 39 39 39 39 39 39 39 39 18 18 18 18 18 18 18 18 18 18 18 18 18 18 18 18 18 18 18 18 18 18 18 18 18 18 18 18 18 18 18 18 18 18 18 18 18 18 18 18 18 18 18 18 18 18 18 18 18 18 18 18 18 18 18 18 18 18 18 18 18 18 18 18 18 18 18 18 18 18 18 18 18 18 18 18 
18 18 18 18 18 18 18 18 18 18 18 18 18 39 39 39 39 38 38 38 38 39 39 39 39 39 18 18 18 18 18 18 18 18 18 18 18 18 18 18 18 18 18 18 18 18 18 18 18 18 18 18 18 18 18 18 18 18 18 18 18 18 18 18 18 18 18 18 18 18 18 18 18 18 18 18 18 18 18 18 18 18 18 18 18 18 18 18 18 18 18 18 18 18 18 18 18 18 18 18 
18 18 18 18 18 18 18 18 18 18 18 18 39 39 39 38 38 38 38 38 38 39 39 39 39 39 39 18 18 18 18 18 18 18 18 18 18 18 18 18 18 18 18 18 18 18 18 18 18 18 18 18 18 18 18 18 18 18 18 18 18 18 18 18 18 18 18 18 18 18 18 18 18 18 18 18 18 18 18 18 18 18 18 18 18 18 18 18 18 18 18 18 18 18 18 18 18 18 18 18 
18 18 18 18 18 18 18 18 18 18 18 18 39 39 38 38 38 38 38 38 38 38 38 38 39 39 39 39 18 18 18 18 18 18 18 18 18 18 18 18 18 18 18 18 18 18 18 18 18 18 18 18 18 18 18 18 18 18 18 18 18 18 18 18 18 18 18 18 18 18 18 18 18 18 18 18 18 18 18 18 18 18 18 18 18 18 18 18 18 18 18 18 18 18 18 18 18 18 18 18 
18 18 18 18 18 18 18 18 18 18 18 39 38 38 38 38 38 38 38 38 38 38 38 38 38 39 39 39 39 39 18 18 18 18 18 18 18 18 18 18 18 18 18 18 18 18 18 18 18 18 18 18 18 18 18 18 18 18 18 18 18 18 18 18 18 18 18 18 18 28 26 26 26 29 18 18 18 18 18 18 18 18 18 18 18 18 18 18 18 18 18 18 18 18 18 18 18 18 18 18 
18 18 18 18 18 18 18 18 18 18 18 39 38 38 38 38 38 38 38 38 38 38 38 38 38 39 39 39 39 39 39 18 18 18 18 18 18 18 18 18 18 18 18 18 18 18 18 18 18 18 18 18 18 18 18 18 18 18 18 18 18 18 18 18 18 18 18 28 26 27 16 16 16 23 18 18 18 18 28 26 26 26 29 18 18 18 18 18 18 18 18 18 18 18 18 18 18 18 18 18 
18 18 18 18 18 18 18 18 18 18 39 39 38 38 38 38 38 38 38 38 38 39 39 39 38 38 39 39 39 39 39 39 18 18 18 18 18 18 18 18 18 18 18 18 18 18 18 18 18 18 26 26 29 18 18 18 18 18 18 18 18 18 18 18 18 18 18 24 16 16 16 16 16 23 18 18 28 26 27 16 16 16 25 26 29 18 18 18 18 18 18 18 18 18 18 18 18 18 18 18 
18 18 18 18 18 18 18 18 18 18 39 39 38 38 38 39 39 39 43 39 38 38 39 39 39 38 38 39 39 39 39 39 39 18 18 18 18 18 18 18 18 18 18 18 18 18 18 18 3 3 10 13 25 26 26 26 26 26 26 26 26 26 26 26 26 26 26 27 16 16 16 20 21 31 28 26 27 1 1 1 2 1 1 16 25 26 29 18 18 18 18 18 18 18 18 18 18 18 18 18 
18 18 18 18 18 18 18 18 18 18 39 39 39 39 38 39 39 39 17 39 39 38 39 39 39 39 38 39 39 39 39 39 39 39 18 18 18 18 18 18 18 18 18 18 18 3 3 3 4 6 3 7 2 16 16 16 16 16 16 16 16 16 16 16 16 16 16 16 16 16 20 31 18 28 27 1 1 1 16 16 1 16 1 1 16 16 25 29 18 18 18 18 18 18 18 18 18 18 18 18 
18 18 18 18 18 18 18 18 18 18 39 39 39 38 38 39 39 39 17 39 39 39 38 39 39 39 38 38 38 39 39 39 39 39 39 3 18 18 18 18 18 18 18 3 3 3 3 3 7 8 3 7 2 2 2 2 2 2 2 2 2 2 2 2 2 2 2 16 16 16 23 18 28 27 1 1 16 16 16 16 1 16 16 1 16 16 16 25 29 18 18 18 18 18 18 18 18 18 18 18 
18 18 18 18 18 18 18 18 18 39 39 39 39 38 39 39 39 39 17 39 39 39 38 38 39 39 39 39 38 38 38 39 39 39 39 3 3 3 3 3 3 3 3 3 3 3 3 3 7 8 3 7 2 16 16 16 16 16 16 16 16 16 16 16 16 16 2 16 16 16 23 18 24 16 1 16 16 16 16 16 1 16 16 1 1 16 16 16 23 18 18 18 18 18 18 18 18 18 18 18 
18 18 18 18 18 18 18 18 18 39 39 39 38 39 39 39 39 39 17 39 39 39 39 38 39 39 39 39 39 38 39 39 39 39 39 39 39 39 3 3 3 3 3 3 3 3 3 39 7 8 3 7 2 16 16 16 16 16 16 16 16 16 16 16 16 16 2 16 16 20 31 28 27 16 1 1 1 1 16 16 1 16 16 16 1 16 16 1 25 29 18 18 18 18 18 18 18 18 18 18 
18 18 18 18 18 18 18 18 39 39 39 39 38 39 39 39 39 39 17 39 39 39 38 38 39 39 39 39 39 38 39 39 39 39 39 39 39 39 39 3 3 39 3 3 3 3 3 39 7 8 3 7 2 16 16 16 16 16 16 16 16 16 16 16 16 16 2 16 16 23 18 24 16 16 16 16 16 1 16 16 1 16 16 16 1 1 1 1 16 23 18 18 18 18 18 18 18 18 18 18 
18 18 18 18 18 18 18 39 39 39 38 38 38 38 39 39 39 39 17 17 39 39 38 39 39 39 39 39 39 38 39 39 39 39 39 39 39 39 40 40 3 3 3 3 3 39 3 3 7 8 3 7 2 2 2 2 2 2 16 16 16 16 16 16 16 16 2 2 16 23 28 27 16 16 16 16 33 1 16 16 1 16 16 16 16 16 16 16 16 25 18 18 18 18 18 18 18 18 18 18 
18 18 18 18 18 18 18 39 39 38 38 39 39 38 39 39 39 39 39 17 17 17 17 39 39 39 39 39 39 38 38 39 39 39 39 39 39 40 40 40 3 39 39 3 3 3 3 3 7 8 3 7 2 16 16 16 16 2 16 16 16 16 2 2 2 16 16 2 16 23 24 1 16 16 16 16 16 16 16 16 1 16 16 16 16 16 16 16 16 16 23 18 18 18 18 18 18 18 18 18 
18 18 18 18 18 18 18 39 39 38 39 39 39 38 38 39 39 39 39 39 39 39 17 39 39 39 39 39 39 39 38 39 39 39 39 39 40 40 40 40 39 3 3 3 3 3 39 3 7 8 3 7 2 16 16 16 16 2 16 16 2 2 2 16 2 16 16 2 16 23 24 1 1 1 1 1 1 1 1 1 2 1 2 2 2 2 2 2 2 16 23 18 18 18 18 18 18 18 18 18 
18 18 18 18 18 18 39 39 39 38 39 39 39 38 38 39 17 17 17 17 17 17 17 39 39 39 39 39 39 39 38 39 39 39 40 40 43 40 40 40 40 3 3 3 3 3 3 3 7 8 3 7 2 16 16 16 16 2 16 2 2 16 16 16 2 16 16 2 16 23 24 16 16 16 16 1 16 16 16 16 1 16 16 16 16 16 16 16 16 16 23 18 18 18 18 18 18 18 18 18 
18 18 18 18 18 18 39 39 38 38 39 39 39 17 17 17 17 39 39 39 39 39 39 39 39 39 39 39 39 39 38 39 40 40 40 40 17 40 40 40 40 39 3 39 3 3 3 3 7 8 3 7 2 16 16 16 2 2 2 2 16 16 16 16 2 16 16 2 16 23 30 22 16 16 16 1 16 16 16 16 1 16 16 16 2 1 16 16 16 20 31 18 18 18 18 18 18 18 18 18 
18 18 18 18 18 18 39 39 38 38 39 39 39 17 39 38 38 39 39 39 39 39 39 39 39 39 39 39 39 40 40 40 40 17 17 17 17 40 39 40 40 40 3 3 3 3 39 3 7 8 3 7 2 16 16 16 2 16 16 2 2 2 2 2 2 16 16 2 16 23 18 24 16 16 16 1 16 1 16 16 1 16 16 16 16 16 16 16 16 23 18 18 18 18 18 18 18 18 18 18 
18 18 18 18 18 39 39 39 38 39 39 39 39 17 39 39 38 39 39 39 39 39 39 39 39 39 39 40 40 40 17 17 17 17 40 40 40 40 40 40 40 40 40 3 3 3 3 3 7 8 3 7 2 16 16 2 2 2 2 2 16 2 2 2 2 16 16 2 16 23 18 30 22 16 16 1 1 1 16 16 1 16 16 16 16 16 16 16 20 31 18 18 18 18 18 18 18 18 18 18 
18 18 18 18 18 39 39 39 38 39 39 39 39 17 39 39 38 39 39 39 39 39 39 39 39 39 40 40 40 17 17 40 40 40 40 40 40 40 40 40 40 40 40 3 3 39 3 3 7 8 3 7 2 16 16 2 16 16 2 2 2 2 2 16 2 16 16 2 16 25 26 29 24 16 16 16 16 16 16 16 1 16 16 16 16 16 16 1 23 18 18 18 18 18 18 18 18 18 18 18 
18 18 18 18 39 39 39 39 38 39 39 39 39 17 39 39 38 39 39 39 39 39 39 39 39 40 40 40 40 17 40 40 40 40 40 40 40 40 40 40 39 39 40 3 39 3 3 3 7 8 3 7 2 16 16 2 2 16 16 16 16 16 16 2 2 16 16 2 16 16 16 23 30 22 16 16 16 16 16 16 1 16 16 16 16 16 1 20 31 18 18 18 18 18 18 18 18 18 18 18 
18 18 18 18 39 39 39 39 38 39 39 39 39 17 17 39 38 39 39 39 39 39 39 39 40 40 17 17 17 17 40 40 40 40 40 40 39 40 40 40 40 40 3 3 3 3 3 3 7 8 3 7 2 16 16 16 2 2 2 16 16 16 16 2 16 16 16 2 16 16 16 23 18 30 22 16 16 16 16 16 1 16 16 16 16 1 20 31 18 28 26 29 18 18 18 18 18 18 18 18 
18 18 18 18 39 39 39 39 38 39 39 39 39 39 17 39 38 39 39 39 39 40 40 40 40 40 17 40 40 40 40 40 40 40 40 40 39 40 40 40 40 40 3 3 3 3 3 3 7 8 3 7 2 16 16 16 16 16 2 2 2 2 2 2 16 16 16 2 2 2 16 25 29 18 30 21 22 16 16 16 1 1 16 1 20 21 31 28 26 27 16 23 18 18 18 18 18 18 18 18 
18 18 18 18 39 39 39 38 38 39 39 39 39 39 17 39 38 39 39 39 40 40 40 40 40 17 17 40 40 40 40 40 40 39 40 40 40 40 40 40 40 3 3 3 3 39 3 3 7 8 3 7 2 16 16 16 16 16 16 16 16 16 16 16 16 16 16 16 16 2 16 16 25 29 18 18 30 21 22 16 1 1 20 21 31 18 18 24 16 16 16 23 18 18 18 18 18 18 18 18 
18 18 18 18 39 39 39 38 38 39 39 39 39 39 17 39 38 40 40 40 40 40 40 40 40 17 40 40 40 40 40 40 40 39 40 40 40 40 40 40 40 3 3 3 3 3 3 3 7 8 3 7 2 16 16 16 16 16 16 16 16 16 16 16 16 16 2 2 2 2 16 16 16 25 26 29 18 18 30 22 1 20 31 18 18 18 28 27 16 16 20 31 18 18 18 18 18 18 18 18 
18 18 18 18 39 39 39 39 38 39 39 39 39 39 17 40 40 40 40 40 40 40 40 40 17 17 40 40 40 40 39 40 40 40 40 40 40 40 40 40 40 3 3 3 3 3 3 3 7 8 3 7 2 16 16 16 16 16 16 16 16 16 16 16 16 16 2 16 16 16 16 16 16 16 16 25 26 26 26 27 1 25 26 26 26 26 27 16 16 16 23 18 18 18 18 18 18 18 18 18 
18 18 18 18 39 39 39 39 38 38 39 39 39 40 17 40 40 40 40 40 40 17 17 17 17 40 40 40 40 40 40 40 40 40 40 40 40 40 39 3 39 3 3 3 3 39 3 3 7 8 3 7 2 16 16 16 16 16 16 16 16 16 16 16 16 16 2 2 2 2 16 16 16 16 16 16 16 16 16 16 2 16 16 16 16 16 16 16 16 20 31 18 18 18 18 18 18 18 18 18 
18 18 18 39 39 39 39 39 39 38 39 39 40 40 3 40 40 40 17 17 17 17 40 40 40 40 40 40 40 40 40 40 40 40 40 3 3 3 3 3 39 39 3 3 3 3 3 3 7 8 3 7 2 16 16 16 16 16 16 16 16 16 16 16 16 16 16 16 16 2 16 16 2 2 2 16 16 16 16 16 2 2 2 2 2 2 16 16 16 23 18 18 18 18 18 18 18 18 18 18 
18 18 18 39 39 39 39 39 39 38 39 39 40 40 3 40 40 17 17 40 40 40 40 40 40 40 40 40 40 40 40 40 3 3 3 3 39 3 3 3 3 3 3 39 3 3 3 3 7 8 3 7 2 16 16 16 16 16 16 16 16 16 16 16 16 2 2 2 2 2 16 16 2 16 2 16 16 16 16 16 16 16 16 16 16 2 16 16 20 31 18 18 18 18 18 18 18 18 18 18 
18 18 18 39 39 39 39 39 39 39 40 40 40 40 3 40 17 17 40 40 40 40 40 3 39 3 3 3 3 3 3 3 3 3 3 39 3 39 3 3 3 3 3 3 3 3 4 5 15 8 3 7 2 16 16 16 16 16 16 16 16 16 16 16 16 16 2 16 16 16 16 16 2 16 2 16 16 16 16 16 16 2 2 2 2 2 16 16 23 18 18 18 18 18 18 18 18 18 18 18 
18 18 18 18 39 39 39 39 40 40 40 40 40 40 3 3 3 40 40 40 40 40 39 3 3 3 39 3 3 39 3 3 3 3 39 3 3 3 4 5 5 5 5 5 5 5 12 10 10 11 3 9 10 10 13 16 16 16 16 16 16 16 16 16 16 16 2 2 2 2 2 2 2 16 2 16 16 16 16 16 16 2 16 16 16 16 16 16 23 18 18 18 18 18 18 18 18 18 18 18 
18 18 18 18 18 18 18 18 18 24 1 40 40 40 40 6 3 9 13 3 3 3 3 3 3 3 39 39 3 39 3 3 3 3 3 39 3 3 7 12 10 10 10 10 10 10 11 32 32 32 3 32 32 32 9 10 10 10 10 10 10 13 16 16 16 16 16 16 16 16 16 16 16 16 2 16 16 16 16 16 16 2 16 16 16 16 16 16 23 18 18 18 18 18 18 18 18 18 18 18 
18 18 18 18 18 18 18 18 18 24 1 40 40 40 40 8 3 3 9 13 5 5 6 3 39 39 3 3 3 3 3 3 39 39 3 3 3 4 12 11 32 32 32 32 32 32 32 32 32 32 3 32 32 32 32 32 32 32 32 32 32 9 13 16 16 16 16 16 16 16 16 16 16 16 2 16 16 16 16 16 16 2 16 16 16 16 16 16 23 18 18 18 18 18 18 18 18 18 18 18 
18 18 18 18 18 18 18 18 18 24 1 1 40 40 40 14 6 3 3 9 10 10 13 6 3 3 3 39 39 3 39 3 3 3 3 3 4 12 11 32 32 4 5 5 5 5 6 32 32 32 3 32 32 32 4 5 5 5 5 6 32 32 9 13 16 16 16 16 16 16 16 16 16 16 2 2 2 2 2 2 2 2 16 16 16 16 16 16 23 18 18 18 18 18 18 18 18 18 18 18 
18 18 18 18 18 18 18 18 18 30 22 1 1 40 40 40 14 6 3 3 3 3 7 2 5 6 3 3 3 3 3 3 3 3 39 4 12 11 32 32 4 15 16 2 33 2 14 5 6 3 3 3 4 5 15 2 33 2 16 14 6 32 32 9 13 16 16 16 16 16 16 16 16 16 16 16 16 16 16 16 16 16 16 16 16 16 16 16 23 18 18 18 18 18 18 18 18 18 18 18 
18 18 18 18 18 18 18 18 18 18 30 21 22 1 1 1 1 14 5 5 6 3 9 10 10 13 5 5 5 6 3 39 3 3 3 7 8 32 32 4 15 10 10 10 10 10 10 10 11 3 3 3 9 10 10 10 10 10 10 10 13 6 32 32 7 16 16 16 16 16 16 16 16 16 2 2 2 2 16 16 16 16 16 16 16 16 16 16 23 18 18 18 18 18 18 18 18 18 18 18 
18 18 18 18 18 18 18 18 18 18 18 18 30 21 21 22 1 1 1 1 8 3 3 3 3 9 10 10 10 13 3 3 39 3 3 7 8 32 4 15 8 3 3 3 3 3 3 3 3 3 3 3 3 3 3 3 3 3 3 3 7 14 6 32 7 16 16 16 16 16 16 16 16 2 2 16 16 2 2 2 16 16 16 16 16 16 16 16 23 18 18 18 18 18 18 18 18 18 18 18 
18 18 18 18 18 18 18 18 18 18 18 18 18 18 18 30 21 21 22 1 14 5 5 6 3 3 3 3 3 7 6 3 3 39 39 7 8 32 7 16 8 3 3 3 3 3 3 3 3 3 3 3 3 3 3 3 3 3 3 3 7 2 8 32 7 16 16 16 16 16 16 16 16 2 2 16 2 16 16 2 16 16 16 16 16 16 16 16 23 18 18 18 18 18 18 18 18 18 18 18 
18 18 18 18 18 18 18 18 18 18 18 18 18 18 18 18 18 18 30 21 21 21 21 22 5 5 5 6 3 9 13 6 3 3 39 7 8 32 7 2 8 3 3 4 5 5 5 5 5 5 5 5 5 5 5 5 5 6 3 3 7 33 8 32 7 16 16 16 16 16 16 16 16 2 2 16 2 16 2 2 16 16 16 16 16 16 16 16 23 18 18 18 18 18 18 18 18 18 18 18 
18 18 18 18 18 18 18 18 18 18 18 18 18 18 18 18 28 26 26 26 26 26 26 26 21 22 1 8 3 3 9 13 6 3 3 7 8 32 7 33 8 3 3 7 1 1 1 16 1 1 1 1 1 16 1 1 1 8 3 3 7 2 8 32 7 16 16 16 16 16 16 16 16 2 16 2 2 16 2 16 16 16 16 16 16 16 16 16 23 18 18 18 18 18 18 18 18 18 18 18 
18 18 18 18 18 18 18 18 18 18 18 18 28 26 26 26 27 1 1 1 1 1 1 1 25 30 22 1 6 3 3 7 8 3 3 7 8 32 7 2 8 3 3 7 1 20 21 21 21 22 1 20 21 21 21 22 1 8 3 3 7 16 8 32 7 16 16 16 16 16 16 16 16 2 2 2 2 2 2 16 16 16 16 16 16 16 16 16 23 18 18 18 18 18 18 18 18 18 18 18 
18 18 18 18 18 18 18 18 18 18 18 28 27 1 1 1 1 1 1 16 1 16 16 1 1 25 30 22 1 6 3 9 13 5 5 12 11 32 9 13 8 3 3 7 16 23 18 18 18 24 1 23 18 18 18 24 1 8 3 3 7 12 11 32 9 13 16 16 16 16 2 2 2 2 16 16 16 16 16 16 16 16 16 16 16 16 16 16 25 29 18 18 18 18 18 18 18 18 18 18 
18 18 18 18 18 18 18 18 18 18 28 27 1 1 1 1 1 16 1 1 1 1 1 1 1 1 25 30 22 8 3 3 9 10 13 8 32 32 32 7 8 3 3 7 1 23 18 28 26 27 1 25 26 29 18 24 16 8 3 3 7 8 32 32 32 7 16 16 16 16 2 16 16 16 16 16 16 16 16 16 16 16 16 16 16 16 16 16 1 23 18 18 18 18 18 18 18 18 18 18 
18 18 18 18 18 18 18 18 18 28 27 1 1 1 1 1 1 1 1 1 1 1 16 1 1 1 1 23 24 1 6 3 3 3 7 8 32 32 32 9 11 3 3 7 1 23 18 24 1 1 1 1 1 23 18 24 1 8 3 3 9 11 32 32 32 7 2 2 2 2 2 2 2 2 2 2 2 2 2 2 2 2 2 2 2 2 2 1 1 23 18 18 18 18 18 18 18 18 18 18 
18 18 18 18 18 18 18 18 28 27 1 1 1 1 16 1 1 16 1 1 33 1 1 1 16 1 1 23 24 1 2 5 6 3 9 11 32 32 32 3 3 3 3 7 1 25 26 27 1 20 21 22 1 25 26 27 1 8 3 3 3 3 32 32 32 9 10 10 10 10 10 10 10 10 10 10 10 10 10 10 10 10 10 10 10 10 10 10 13 23 18 18 18 18 18 18 18 18 18 18 
18 18 18 18 18 18 18 28 27 1 1 1 16 1 1 1 1 1 16 1 1 1 16 1 1 16 1 23 24 1 2 2 8 3 3 3 3 3 3 3 3 3 3 7 1 1 1 1 1 23 19 24 1 1 1 1 1 8 3 3 3 3 3 3 3 3 3 3 3 3 3 3 3 3 3 3 3 3 3 3 3 3 3 3 3 3 3 3 7 23 18 18 18 18 18 18 18 18 18 18 
18 18 18 18 18 18 28 27 1 1 1 1 16 1 16 16 1 1 1 16 1 16 1 1 16 1 1 23 24 1 2 2 14 5 5 6 32 32 32 3 3 3 3 7 1 20 21 22 1 25 26 27 1 20 21 22 1 8 3 3 3 3 32 32 32 4 5 5 5 5 5 5 5 5 5 5 5 5 5 5 5 5 5 5 5 5 5 5 15 23 18 18 18 18 18 18 18 18 18 18 
18 18 18 18 18 18 24 1 1 1 1 1 1 1 16 1 1 1 1 1 1 1 1 16 1 1 1 23 24 1 1 1 1 1 1 8 32 32 32 4 6 3 3 7 16 23 18 24 1 1 1 1 1 23 18 24 1 8 3 3 4 6 32 32 32 7 16 16 16 16 16 16 16 16 16 16 16 16 16 16 16 16 16 16 16 16 16 16 8 3 18 18 18 18 18 18 18 18 18 18 
18 18 18 18 18 28 27 1 1 16 1 1 1 16 1 1 1 1 1 1 1 1 1 1 1 20 21 31 24 1 1 1 16 16 1 8 32 32 32 7 8 3 3 7 1 23 18 30 21 22 1 20 21 31 18 24 1 8 3 3 7 8 32 32 32 9 10 10 10 10 10 10 10 10 10 10 10 10 10 10 10 10 10 10 10 10 10 10 11 3 3 18 18 18 18 18 18 18 18 18 
18 18 18 18 18 24 1 1 1 16 16 1 1 1 1 20 21 21 21 21 21 21 21 21 21 31 18 18 24 1 1 1 1 1 1 14 6 32 4 15 8 3 3 7 1 23 18 18 18 24 1 23 18 18 18 24 16 8 3 3 7 14 6 32 3 3 3 3 3 3 3 3 3 3 3 3 3 3 3 3 3 3 3 3 3 3 3 3 3 3 3 18 18 18 18 18 18 18 18 18 
18 18 18 18 18 24 1 1 1 1 1 1 1 1 20 31 18 18 18 18 18 18 18 18 18 18 18 18 24 1 1 16 1 1 1 1 8 32 7 16 8 3 3 7 1 25 26 26 26 27 1 25 26 26 26 27 1 8 3 3 7 2 8 32 3 3 3 3 3 3 3 3 3 3 3 3 3 3 3 3 3 3 3 3 3 3 3 3 3 3 3 18 18 18 18 18 18 18 18 18 
18 18 18 18 28 27 1 1 1 1 1 1 1 20 31 26 26 26 26 26 26 26 26 26 29 18 18 18 24 1 1 1 1 16 16 1 8 32 7 2 8 3 3 7 1 1 16 1 16 1 1 1 1 16 16 1 1 8 3 3 7 33 8 32 3 3 3 3 3 3 3 3 3 3 3 3 3 3 3 3 3 3 3 3 3 3 3 3 3 3 3 18 18 18 18 18 18 18 18 18 
18 18 18 18 24 1 1 16 1 1 16 1 1 25 27 1 1 1 1 1 1 1 1 1 23 18 18 18 30 22 1 1 1 1 16 1 8 32 7 33 8 3 3 9 10 10 10 10 10 10 10 10 10 10 10 10 10 11 3 3 7 2 8 32 3 3 3 3 3 3 3 3 3 3 3 3 32 32 32 32 32 32 32 32 3 3 3 3 3 3 3 18 18 18 18 18 18 18 18 18 
18 18 18 18 24 1 1 1 1 16 1 1 1 1 1 1 1 16 1 16 1 1 1 1 25 29 18 18 18 30 22 1 1 1 1 1 8 32 7 2 8 3 3 3 3 3 3 3 3 3 3 3 3 3 3 3 3 3 3 3 7 16 8 32 3 3 3 3 3 3 3 3 3 32 32 32 32 17 17 17 17 17 17 32 32 3 3 3 3 3 3 18 18 18 18 18 18 18 18 18 
18 18 18 18 24 1 1 1 1 1 1 1 1 1 16 1 1 1 1 1 1 16 16 1 1 25 29 18 18 18 24 1 1 1 16 1 8 32 9 13 8 3 3 3 3 3 3 3 3 3 3 3 3 3 3 3 3 3 3 3 7 12 11 32 3 3 3 3 3 3 3 3 32 32 17 17 17 17 32 32 32 32 17 17 32 3 3 3 3 3 3 18 18 18 18 18 18 18 18 18 
18 18 18 18 24 1 16 16 16 1 1 16 1 1 1 1 1 16 1 1 1 16 1 16 1 1 25 26 29 18 30 22 1 1 16 1 8 32 32 9 13 5 5 5 5 5 5 5 6 3 3 3 4 5 5 5 5 5 5 5 15 11 32 32 3 3 3 3 3 3 3 3 32 17 17 32 32 32 32 17 17 32 32 17 32 3 3 3 3 3 18 18 18 18 18 18 18 18 18 18 
18 18 18 18 24 1 1 1 1 1 1 1 1 1 1 16 1 1 16 1 1 1 1 1 16 1 1 1 23 18 18 24 1 1 1 1 14 6 32 32 9 13 16 2 33 2 12 10 11 3 3 3 9 10 13 16 2 33 2 12 11 32 32 3 3 3 3 3 3 3 3 32 32 17 32 17 17 17 17 17 17 17 32 17 32 3 3 3 3 3 18 18 18 18 18 18 18 18 18 18 
18 18 18 18 24 1 1 1 16 1 1 1 1 16 1 1 1 1 16 1 1 1 1 1 1 1 1 1 23 18 18 30 22 1 1 1 1 14 6 32 32 9 10 10 10 10 11 32 32 32 3 32 32 32 9 10 10 10 10 11 32 32 3 3 3 3 3 3 3 3 3 32 17 17 32 17 17 17 17 17 32 17 32 17 32 32 3 3 3 3 18 18 18 18 18 18 18 18 18 18 
18 18 18 18 24 1 1 1 16 16 1 1 1 1 1 1 1 1 1 1 16 16 1 16 16 16 1 1 23 18 18 18 24 1 1 16 1 1 14 6 32 32 32 32 32 32 32 32 32 32 3 32 32 32 32 32 32 32 32 32 32 3 3 3 3 3 3 3 3 3 32 17 17 32 32 17 32 32 32 17 17 17 32 17 17 32 32 3 3 3 18 18 18 18 18 18 18 18 18 18 
18 18 18 18 24 1 1 1 1 1 1 1 1 1 1 1 1 1 1 1 1 1 1 1 1 16 1 1 23 18 18 18 24 1 16 1 1 1 1 14 5 5 5 5 5 5 6 32 32 32 3 32 32 32 3 3 3 3 3 3 3 3 3 3 3 3 3 3 3 32 32 17 32 17 17 17 17 17 32 32 17 17 32 32 17 17 32 3 3 3 18 18 18 18 18 18 18 18 18 18 
18 18 18 18 24 1 1 1 1 1 1 1 1 16 1 20 22 1 1 1 1 1 1 1 1 16 1 1 23 18 18 18 24 1 1 1 1 16 1 1 16 1 1 1 1 1 14 5 5 6 3 3 3 3 3 3 3 3 3 3 3 3 32 32 32 32 32 32 32 32 17 17 17 17 32 32 32 17 17 32 32 17 17 32 32 17 32 3 3 3 18 18 18 18 18 18 18 18 18 18 
18 18 18 18 30 21 22 1 1 1 1 1 1 1 1 25 18 21 22 1 1 1 1 1 16 1 1 1 23 18 18 18 24 1 1 16 1 1 1 1 1 1 16 1 16 1 1 1 1 8 3 3 3 3 3 32 32 32 32 32 32 32 32 17 17 17 17 17 17 17 17 17 17 32 32 36 32 32 17 17 32 32 17 17 32 17 32 3 3 3 18 18 18 18 18 18 18 18 18 18 
18 18 18 18 18 18 24 1 1 1 1 16 1 1 1 1 25 18 30 21 22 1 1 1 1 1 1 20 31 18 18 18 24 1 1 16 1 1 1 1 16 1 1 1 1 1 1 1 1 8 3 3 3 3 32 32 17 17 17 17 17 17 17 17 17 17 17 17 17 32 17 17 32 32 17 17 17 32 32 17 17 32 32 17 32 17 32 32 3 3 18 18 18 18 18 18 18 18 18 18 
18 18 18 18 18 18 30 21 22 1 1 1 1 1 1 1 1 25 26 26 30 21 22 1 1 1 20 31 18 18 18 18 24 1 1 1 1 1 1 1 1 16 1 1 1 1 16 1 16 8 3 3 3 3 32 17 17 17 17 17 17 17 17 17 17 32 17 32 17 17 17 32 32 17 17 17 17 17 32 32 17 17 32 32 32 17 17 32 3 3 3 18 18 18 18 18 18 18 18 18 
18 18 18 18 18 18 18 18 24 1 1 1 1 1 16 1 1 1 1 1 25 26 30 21 21 21 31 18 18 18 28 26 27 1 16 1 16 1 1 1 1 16 16 1 1 1 1 1 16 8 3 3 3 3 32 32 32 32 17 32 32 32 32 32 17 32 17 32 17 17 32 32 17 17 17 17 17 17 17 32 32 17 17 32 32 32 17 32 3 3 3 18 18 18 18 18 18 18 18 18 
18 18 18 18 18 18 18 18 24 1 1 16 16 1 1 1 1 1 1 1 1 1 25 26 26 26 29 18 18 28 27 1 1 1 1 1 1 1 1 1 1 1 16 16 1 16 1 1 1 8 3 3 3 3 32 17 17 32 17 32 17 17 17 32 17 32 17 32 17 32 32 17 17 17 17 17 17 17 17 17 32 32 17 17 17 32 17 32 3 3 3 18 18 18 18 18 18 18 18 18 
18 18 18 18 18 18 18 18 24 1 1 16 1 1 1 1 16 1 1 1 1 1 1 1 1 1 25 26 26 27 1 1 1 1 16 1 1 1 1 1 1 1 1 16 1 1 1 16 1 8 3 3 3 32 32 36 17 17 17 17 17 36 17 32 17 32 17 32 17 32 17 17 17 17 17 17 17 17 17 17 17 32 17 32 17 32 17 32 3 3 3 18 18 18 18 18 18 18 18 18 
18 18 18 18 18 18 18 18 24 1 1 16 1 1 1 16 1 1 16 1 1 1 16 1 1 1 1 1 1 1 1 1 1 1 1 16 16 16 16 16 1 1 1 16 1 1 1 16 1 8 3 3 3 32 17 17 17 32 17 32 17 17 17 32 17 32 17 32 17 32 32 17 17 17 17 17 17 17 17 17 32 32 17 32 17 32 17 32 3 3 3 3 18 18 18 18 18 18 18 18 
18 18 18 18 18 18 18 18 24 1 1 16 1 1 1 16 1 1 1 1 16 1 1 16 1 1 1 20 21 21 21 22 1 1 1 1 1 1 1 1 1 1 1 1 1 1 1 16 1 8 3 3 3 32 32 32 32 32 17 32 32 32 32 32 17 32 17 32 17 17 32 32 17 17 17 17 17 17 17 32 32 17 17 32 17 32 17 32 3 3 3 3 18 18 18 18 18 18 18 18 
18 18 18 18 18 18 18 28 27 1 1 1 16 1 1 1 1 1 1 1 1 1 1 1 1 20 21 31 18 18 18 30 21 21 22 1 1 1 1 1 1 16 16 16 16 1 1 16 1 8 3 3 3 32 17 17 17 32 17 32 17 17 17 32 17 32 17 32 17 17 17 32 32 17 17 17 17 17 32 32 17 17 32 32 17 32 17 32 3 3 3 3 18 18 18 18 18 18 18 18 
18 18 18 18 18 18 18 24 1 1 1 1 1 1 1 1 1 1 1 1 1 20 21 21 21 31 18 18 18 18 18 18 18 18 30 22 1 1 1 1 1 1 1 1 1 1 1 1 1 8 3 3 3 32 17 36 17 17 17 17 17 36 17 32 17 32 17 32 17 17 17 17 32 32 17 17 17 32 32 17 17 32 32 17 17 32 17 32 3 3 3 3 18 18 18 18 18 18 18 18 
18 18 18 18 18 18 18 18 3 3 3 3 3 3 3 3 3 3 3 21 21 31 18 18 18 18 18 18 18 18 18 18 18 18 18 30 22 1 10 10 13 1 1 1 1 1 1 1 1 8 3 3 3 32 17 17 17 32 17 32 17 17 17 32 17 32 17 32 17 17 17 17 17 32 32 17 32 32 17 17 32 32 17 17 32 17 17 32 3 3 3 3 18 18 18 18 18 18 18 18 
18 18 18 18 18 18 18 3 3 3 3 3 3 3 3 3 3 3 3 18 18 18 18 18 18 18 18 18 18 18 18 18 18 18 18 18 30 21 3 3 7 1 1 16 1 1 1 1 1 8 3 3 3 32 32 32 32 32 17 32 32 32 32 32 17 32 32 32 17 32 32 32 32 32 32 17 17 17 17 32 32 17 17 17 32 17 32 32 3 3 3 3 18 18 18 18 18 18 18 18 
18 18 18 18 18 18 3 3 3 3 3 4 5 6 3 3 3 3 18 18 18 18 18 18 18 18 18 18 18 18 18 18 18 18 18 18 18 18 3 3 7 1 1 16 1 1 1 16 1 8 3 3 3 32 17 17 17 32 17 17 17 17 17 17 17 17 17 17 17 32 17 17 32 36 32 32 32 32 32 32 17 17 32 17 32 17 32 3 3 3 3 3 18 18 18 18 18 18 18 18 
18 18 18 18 18 18 3 3 3 4 5 15 1 14 5 6 3 3 18 18 18 18 18 18 18 18 18 18 18 18 18 18 18 18 18 18 18 18 3 3 7 1 1 16 1 1 1 16 1 8 3 3 3 32 17 36 17 17 17 32 17 17 17 17 32 17 17 32 32 17 17 32 32 17 17 17 32 32 32 17 17 17 32 17 32 17 32 3 3 3 3 3 18 18 18 18 18 18 18 18 
18 18 18 18 18 18 3 3 4 15 1 1 1 1 1 8 3 18 18 18 18 18 18 18 18 18 18 18 18 18 18 18 18 18 18 18 18 18 3 3 7 1 1 16 1 1 1 16 1 8 3 3 3 32 17 17 17 32 17 32 17 17 32 17 32 32 32 32 17 17 32 32 32 32 32 17 17 17 32 32 32 17 17 17 32 17 32 3 3 3 3 3 18 18 18 18 18 18 18 18 
18 18 18 18 18 18 3 3 7 1 1 1 1 16 1 8 3 18 18 18 18 18 18 18 18 18 18 18 18 18 18 18 18 18 18 18 18 18 3 3 7 1 1 16 1 1 16 1 1 8 3 3 3 32 32 32 32 32 17 32 32 17 32 17 17 17 17 17 17 32 32 3 3 3 32 32 32 17 17 17 32 32 32 36 32 17 32 3 3 3 3 3 18 18 18 18 18 18 18 18 
18 18 18 18 18 3 3 3 7 1 16 1 16 1 12 11 3 3 3 3 3 18 18 18 18 18 18 18 18 18 18 18 18 18 18 18 18 3 3 3 7 1 1 1 1 16 16 1 1 8 3 3 3 3 3 32 32 32 17 17 32 17 32 17 17 17 32 32 32 32 3 3 3 3 3 3 32 32 32 17 17 17 32 32 32 17 32 3 3 3 3 3 18 18 18 18 18 18 18 18 
18 18 18 18 18 3 3 3 7 1 16 1 16 1 8 3 3 3 3 3 3 3 3 3 18 18 18 18 18 18 18 18 18 18 18 3 3 3 3 4 1 1 16 1 1 1 1 1 1 8 3 3 3 3 3 3 3 32 32 17 17 17 32 17 32 32 32 3 3 3 3 3 3 3 3 3 3 3 32 32 32 17 17 17 17 17 32 3 3 3 3 3 18 18 18 18 18 18 18 18 
18 18 18 18 18 3 3 3 9 13 1 16 1 1 8 3 3 3 3 3 3 3 3 3 3 3 3 3 3 18 18 18 18 18 3 3 3 3 4 15 1 16 1 1 1 16 1 16 1 8 3 3 3 3 3 3 3 3 3 32 32 17 32 32 32 3 3 3 3 3 3 3 3 3 3 3 3 3 3 3 32 32 32 17 17 32 32 3 3 3 3 3 18 18 18 18 18 18 18 18 
18 18 18 18 18 3 3 3 3 7 1 1 1 1 8 3 3 3 3 3 3 3 3 3 3 3 3 3 3 3 3 3 3 3 3 3 3 3 9 10 10 10 10 10 10 13 1 1 1 8 3 3 3 3 3 3 3 3 3 3 32 17 32 3 3 3 3 3 3 3 3 3 3 3 3 3 3 3 3 3 3 3 32 32 32 32 3 3 3 3 3 18 18 18 18 18 18 18 18 18 
18 18 18 18 18 3 3 3 3 7 1 1 1 1 8 3 3 3 3 18 18 3 3 3 3 3 3 3 3 3 3 3 3 3 3 3 3 3 3 3 3 3 3 3 3 9 10 10 13 8 3 3 3 3 3 3 3 3 3 3 3 3 3 3 3 3 3 3 3 3 3 3 3 3 3 3 3 3 3 3 3 3 3 3 3 3 3 3 3 3 3 18 18 18 18 18 18 18 18 18 
18 18 18 18 18 3 3 3 3 9 10 10 10 10 11 3 3 18 18 18 18 18 18 18 18 18 3 3 3 3 3 3 3 3 3 3 3 3 3 3 3 18 18 18 3 3 3 3 7 8 3 3 3 3 3 3 3 3 3 3 3 3 3 3 3 3 3 3 3 3 3 3 3 3 3 3 3 3 3 3 3 3 3 3 3 3 3 3 3 3 3 18 18 18 18 18 18 18 18 18 
18 18 18 18 18 18 18 3 3 3 3 3 3 3 3 3 18 18 18 18 18 18 18 18 18 18 18 18 18 3 3 3 3 3 3 3 3 3 3 18 18 18 18 18 18 18 18 3 9 11 3 3 3 3 3 3 3 3 3 3 3 3 3 3 3 3 3 3 3 3 3 3 3 3 3 3 3 3 3 3 3 3 3 3 3 3 3 3 3 3 3 18 18 18 18 18 18 18 18 18 
18 18 18 18 18 18 18 18 18 18 3 3 3 3 3 3 18 18 18 18 18 18 18 18 18 18 18 18 18 18 3 3 3 3 3 3 3 3 3 18 18 18 18 18 18 18 18 3 3 3 3 3 3 3 3 3 3 3 3 3 3 3 3 3 3 3 3 3 3 3 3 3 3 3 3 3 3 3 3 3 3 3 3 3 3 3 3 3 3 3 18 18 18 18 18 18 18 18 18 18 
18 18 18 18 18 18 18 18 18 18 18 18 18 18 18 18 18 18 18 18 18 18 18 18 18 18 18 18 18 18 18 18 18 18 18 18 18 18 18 18 18 18 18 18 18 18 18 18 18 18 18 18 18 18 18 18 18 3 3 3 3 3 3 3 3 3 3 3 3 3 3 3 3 3 3 3 3 3 3 3 3 3 3 3 3 3 3 3 18 18 18 18 18 18 18 18 18 18 18 18 
18 18 18 18 18 18 18 18 18 18 18 18 18 18 18 18 18 18 18 18 18 18 18 18 18 18 18 18 18 18 18 18 18 18 18 18 18 18 18 18 18 18 18 18 18 18 18 18 18 18 18 18 18 18 18 18 18 18 18 18 18 3 3 3 3 3 3 3 3 3 3 3 3 3 3 3 3 3 3 3 3 3 3 3 3 3 3 18 18 18 18 18 18 18 18 18 18 18 18 18 
18 18 18 18 18 18 18 18 18 18 18 18 18 18 18 18 18 18 18 18 18 18 18 18 18 18 18 18 18 18 18 18 18 18 18 18 18 18 18 18 18 18 18 18 18 18 18 18 18 18 18 18 18 18 18 18 18 18 18 18 18 18 18 18 18 18 18 18 18 18 18 18 18 18 18 18 18 18 18 18 18 18 18 18 18 18 18 18 18 18 18 18 18 18 18 18 18 18 18 18 
18 18 18 18 18 18 18 18 18 18 18 18 18 18 18 18 18 18 18 18 18 18 18 18 18 18 18 18 18 18 18 18 18 18 18 18 18 18 18 18 18 18 18 18 18 18 18 18 18 18 18 18 18 18 18 18 18 18 18 18 18 18 18 18 18 18 18 18 18 18 18 18 18 18 18 18 18 18 18 18 18 18 18 18 18 18 18 18 18 18 18 18 18 18 18 18 18 18 18 18 
18 18 18 18 18 18 18 18 18 18 18 18 18 18 18 18 18 18 18 18 18 18 18 18 18 18 18 18 18 18 18 18 18 18 18 18 18 18 18 18 18 18 18 18 18 18 18 18 18 18 18 18 18 18 18 18 18 18 18 18 18 18 18 18 18 18 18 18 18 18 18 18 18 18 18 18 18 18 18 18 18 18 18 18 18 18 18 18 18 18 18 18 18 18 18 18 18 18 18 18 
18 18 18 18 18 18 18 18 18 18 18 18 18 18 18 18 18 18 18 18 18 18 18 18 18 18 18 18 18 18 18 18 18 18 18 18 18 18 18 18 18 18 18 18 18 18 18 18 18 18 18 18 18 18 18 18 18 18 18 18 18 18 18 18 18 18 18 18 18 18 18 18 18 18 18 18 18 18 18 18 18 18 18 18 18 18 18 18 18 18 18 18 18 18 18 18 18 18 18 18 
18 18 18 18 18 18 18 18 18 18 18 18 18 18 18 18 18 18 18 18 18 18 18 18 18 18 18 18 18 18 18 18 18 18 18 18 18 18 18 18 18 18 18 18 18 18 18 18 18 18 18 18 18 18 18 18 18 18 18 18 18 18 18 18 18 18 18 18 18 18 18 18 18 18 18 18 18 18 18 18 18 18 18 18 18 18 18 18 18 18 18 18 18 18 18 18 18 18 18 18 
18 18 18 18 18 18 18 18 18 18 18 18 18 18 18 18 18 18 18 18 18 18 18 18 18 18 18 18 18 18 18 18 18 18 18 18 18 18 18 18 18 18 18 18 18 18 18 18 18 18 18 18 18 18 18 18 18 18 18 18 18 18 18 18 18 18 18 18 18 18 18 18 18 18 18 18 18 18 18 18 18 18 18 18 18 18 18 18 18 18 18 18 18 18 18 18 18 18 18 18 
18 18 18 18 18 18 18 18 18 18 18 18 18 18 18 18 18 18 18 18 18 18 18 18 18 18 18 18 18 18 18 18 18 18 18 18 18 18 18 18 18 18 18 18 18 18 18 18 18 18 18 18 18 18 18 18 18 18 18 18 18 18 18 18 18 18 18 18 18 18 18 18 18 18 18 18 18 18 18 18 18 18 18 18 18 18 18 18 18 18 18 18 18 18 18 18 18 18 18 18 
18 18 18 18 18 18 18 18 18 18 18 18 18 18 18 18 18 18 18 18 18 18 18 18 18 18 18 18 18 18 18 18 18 18 18 18 18 18 18 18 18 18 18 18 18 18 18 18 18 18 18 18 18 18 18 18 18 18 18 18 18 18 18 18 18 18 18 18 18 18 18 18 18 18 18 18 18 18 18 18 18 18 18 18 18 18 18 18 18 18 18 18 18 18 18 18 18 18 18 18 
